A Linear Story
An Interactive Fiction by Sam Heckle
Release 1 / Serial number 220502 / Inform 7 build 6M62 (I6/v6.34 lib 6/12N) SD

Death
Emerging from the Revelation, the journey finished, you take a deep breath. A seemingly endless labyrinth of thinking. A pattern only broken by Death itself. 

You think you see a gnarled old redwood tree out here.

 It didn't have to be this way. Maybe you can retrace your steps.

>ROOMS
That's not a verb I recognise.

>go inside
Revelation

>go outside
End
The journey finished, you take a deep breath.

>go revelation
You can't see any such thing.

>go Revelation
You can't see any such thing.

* * *

A Linear Story
An Interactive Fiction by Sam Heckle
Release 1 / Serial number 220502 / Inform 7 build 6M62 (I6/v6.34 lib 6/12N) SD

Death
Emerging from the Revelation, the journey finished, you take a deep breath. A seemingly endless labyrinth of thinking. A pattern only broken by Death itself. 

You think you see a gnarled old redwood tree out here.

 It didn't have to be this way. Maybe you can retrace your steps.

>brainstorm
You need to be in a place with flow to do this.

>go revelation
Revelation
It seems ages since you came to your last conclusion. You had a big idea, but not sure where it ran off to. You can end it here, embracing the eternal slumber. You remembered spiraling down there earlier. Do you remember what you were feeling so anxious about?

>go spiral
Spiraling
Round and round we go again. Your cyclical thoughts float around the room, taunting you. You did start spiraling from some type of idea, but it seems there you have no logic here. Is this healthy? To stay here, thinking the same thought over and over, unable to break the pattern?

Maybe there is a revelation soon if you wait awhile.

>go thiknk
That noun did not make sense in this context.

>go think
Thoughts
You hit the flow, entering a thoughtful space. Maybe if you looked into an idea you might be able to find something. You can linger on the decision you had made. 

 You don't know if the choice was optional, something thrust upon you. You might end up spiraling, ruminating on the choices that you made. The choices that plague your mind.

An idea floats around.

>brainstorm
Thinking...about choices. choices i made. choices that were taken from me.

You get into the idea.

>brainstorm
You get out of the idea.

Thoughts
You hit the flow, entering a thoughtful space. Maybe if you looked into an idea you might be able to find something. You can linger on the decision you had made. 

 You don't know if the choice was optional, something thrust upon you. You might end up spiraling, ruminating on the choices that you made. The choices that plague your mind.

An idea floats around.

>brainstorm
Thinking...my heart isn't full its just anxious and worried about the future all the time. is there something beyond this?

You get into the idea.

* * *

A Linear Story
An Interactive Fiction by Sam Heckle
Release 1 / Serial number 220502 / Inform 7 build 6M62 (I6/v6.34 lib 6/12N) SD

Death
Emerging from the Revelation, the journey finished, you take a deep breath. A seemingly endless labyrinth of thinking. A pattern only broken by Death itself. 

You think you see a gnarled old redwood tree out here.

 It didn't have to be this way. Maybe you can retrace your steps.

>enter revelation
You can't see any such thing.

>enter Revelation
You can't see any such thing.

* * *

>enter revelation
You can't see any such thing.

>showme
End - room
    yourself - person
    gnarled old redwood tree

* * *

A Linear Story
An Interactive Fiction by Sam Heckle
Release 1 / Serial number 220502 / Inform 7 build 6M62 (I6/v6.34 lib 6/12N) SD

Death
Emerging from the Revelation, the journey finished, you take a deep breath. A seemingly endless labyrinth of thinking. A pattern only broken by Death itself. 

You think you see a gnarled old redwood tree out here.

 It didn't have to be this way. Maybe you can retrace your steps.

>go Revelation
Revelation

>go Crossing
You can't see any such thing.

>go down
Crossing

>go End
You can't see any such thing.

>go inside
Thoughts
An idea floats around.

>take idea
It's far too heavy to lift.

>what idea
That's not a verb I recognise.

* * *

A Linear Story
An Interactive Fiction by Sam Heckle
Release 1 / Serial number 220502 / Inform 7 build 6M62 (I6/v6.34 lib 6/12N) SD

Death
Emerging from the Revelation, the journey finished, you take a deep breath. A seemingly endless labyrinth of thinking. A pattern only broken by Death itself. 

You think you see a gnarled old redwood tree out here.

 It didn't have to be this way. Maybe you can retrace your steps.

>go inside
Revelation
It seems ages since you came to your last conclusion. You had a big idea, but not sure where it ran off to. You can end it here, embracing the eternal slumber. You remembered spiraling down there earlier. Do you remember what you were feeling so anxious about?

>go down
Spiraling
Round and round we go again. Your cyclical thoughts float around the room, taunting you. You did start spiraling from some type of idea, but it seems there you have no logic here. Is this healthy? To stay here, thinking the same thought over and over, unable to break the pattern?

Maybe there is a revelation soon if you wait awhile.

>go down
You can't go that way.

>go up
Revelation
It seems ages since you came to your last conclusion. You had a big idea, but not sure where it ran off to. You can end it here, embracing the eternal slumber. You remembered spiraling down there earlier. Do you remember what you were feeling so anxious about?

>go down
Spiraling
Round and round we go again. Your cyclical thoughts float around the room, taunting you. You did start spiraling from some type of idea, but it seems there you have no logic here. Is this healthy? To stay here, thinking the same thought over and over, unable to break the pattern?

Maybe there is a revelation soon if you wait awhile.

>go inside
Thoughts
You hit the flow, entering a thoughtful space. Maybe if you looked into an idea you might be able to find something. You can linger on the decision you had made. 

 You don't know if the choice was optional, something thrust upon you. You might end up spiraling, ruminating on the choices that you made. The choices that plague your mind.

An idea floats around.

>go up
Decision
Was this a great choice? At least you made one. You can think about it further ahead. You descended here from the choice that was presented to you, and now you must live in your decision.

>think further ahead
I only understood you as far as wanting to think.

>further ahead
That noun did not make sense in this context.

>look further ahead
You can't see any such thing.

>go further ahead
Thoughts
You hit the flow, entering a thoughtful space. Maybe if you looked into an idea you might be able to find something. You can linger on the decision you had made. 

 You don't know if the choice was optional, something thrust upon you. You might end up spiraling, ruminating on the choices that you made. The choices that plague your mind.

An idea floats around.

I beg your pardon?

>go further ahead
There is nothing ahead here.

>go decide
That noun did not make sense in this context.

* * *

>go down
Spiraling
Round and round we go again. Your cyclical thoughts float around the room, taunting you. You did start spiraling from some type of idea, but it seems there you have no logic here. Is this healthy? To stay here, thinking the same thought over and over, unable to break the pattern?

Maybe there is a revelation soon if you wait awhile.

>go inside
Thoughts
An idea floats around.

>go inside
You can't go that way.

>enter idea
thinking...

You get into the idea.

>go out
You would have to get out of the idea first.

>get out
You get out of the idea.

Thoughts
An idea floats around.

>enter idea
wow
You get into the idea.

>get out
You get out of the idea.

Thoughts
An idea floats around.

>enter idea
wow2
You get into the idea.

>get out
You get out of the idea.

Thoughts
An idea floats around.

>go up
Decision

>go up
Naming

>go inside
Birth

>go down
Revelation

>go out
End
Emerging from the revelation, the journey finished, you take a deep breath. It didn't have to be this way. Maybe you can retrace your steps.

* * *

A Linear Story
An Interactive Fiction by Sam Heckle
Release 1 / Serial number 220502 / Inform 7 build 6M62 (I6/v6.34 lib 6/12N) SD

Death
Emerging from the Revelation, the journey finished, you take a deep breath. A seemingly endless labyrinth of thinking. A pattern only broken by Death itself. 

You think you see a gnarled old redwood tree out here.

 It didn't have to be this way. Maybe you can retrace your steps.

>go revelatio
Revelation
It seems ages since you came to your last conclusion. You had a big idea, but not sure where it ran off to. You can end it here, embracing the eternal slumber. You remembered spiraling down there earlier. Do you remember what you were feeling so anxious about?

>go spiral
Spiraling
Round and round we go again. Your cyclical thoughts float around the room, taunting you. You did start spiraling from some type of idea, but it seems there you have no logic here. Is this healthy? To stay here, thinking the same thought over and over, unable to break the pattern?

Maybe there is a revelation soon if you wait awhile.

>go thoughts
Thoughts
You hit the flow, entering a thoughtful space. Maybe if you looked into an idea you might be able to find something. You can linger on the decision you had made. 

 You don't know if the choice was optional, something thrust upon you. You might end up spiraling, ruminating on the choices that you made. The choices that plague your mind.

An idea floats around.

>brainstorm
Thinking...about choices. choices i made. choices that were taken from me.

You get into the idea.

>brainstorm
Thinking...my heart isn't full its just anxious and worried about the future all the time. is there something beyond this?

You get into the idea.

>brainstorm
Thinking...how do i handle obsession? is there any way to make it easier to bear? how do normal people do this? 

what is normal even?

You get into the idea.

>look
Thoughts (in the idea)
You hit the flow, entering a thoughtful space. Maybe if you looked into an idea you might be able to find something. You can linger on the decision you had made. 

 You don't know if the choice was optional, something thrust upon you. You might end up spiraling, ruminating on the choices that you made. The choices that plague your mind.

>look idea
Each idea seems to be worth exploring. Brainstorming is always a fruitful adventure that is worth iterating on.

>brainstorm
Thinking...have i even had an original thought ever in my life?

You get into the idea.

>linger on the descision
I only understood you as far as wanting to linger.

* * *

A Linear Story
An Interactive Fiction by Sam Heckle
Release 1 / Serial number 220502 / Inform 7 build 6M62 (I6/v6.34 lib 6/12N) SD

Death
Emerging from the Revelation, the journey finished, you take a deep breath. A seemingly endless labyrinth of thinking. A pattern only broken by Death itself. 

You think you see a gnarled old redwood tree out here.

 It didn't have to be this way. Maybe you can retrace your steps.

>go revelation
Revelation
It seems ages since you came to your last conclusion. You had a big idea, but not sure where it ran off to. You can end it here, embracing the eternal slumber. You remembered spiraling down there earlier. Do you remember what you were feeling so anxious about?

>down
You can't go that way.

>inside
Revelation
What's the big idea? It seems ages since you came to your last conclusion. You can end it here. Or you can go back to the spiral.

>go spiral
Spiraling
Round and round we go again. You came out from logical thinking, but it seems never ending here now. Maybe there is a revelation soon if you wait awhile.

>go think
Thoughts
Thinking thoughts hard. Maybe if you looked into an idea you might be able to find something. You can linger on the decision you just came from as well.

An idea floats around.

>go decision
Decision
Was this a great choice? At least you made one. You can think about it further ahead, or you can head back up to the Naming.

>go naming
Thoughts
Thinking thoughts hard. Maybe if you looked into an idea you might be able to find something. You can linger on the decision you just came from as well.

An idea floats around.

>go decision
Decision
Was this a great choice? At least you made one. You can think about it further ahead, or you can head back up to the Naming.

>go up
Naming
Emerging from birth you were set for something. Was your name a blessing or a curse?

>go birth
Birth
The birth of an idea. The beginning of a new story. You can go be named, but you feel a sudden revelation.

>go revelation
Which do you mean, the down or the inside?

>down
Revelation
What's the big idea? It seems ages since you came to your last conclusion. You can end it here. Or you can go back to the spiral.

>go end
    *** The End ***

Would you like to RESTART, RESTORE a saved game, QUIT or UNDO the last command?

* * *

>go revelation
Revelation
It seems ages since you came to your last conclusion. You had a big idea, but not sure where it ran off to. You can end it here, embracing the eternal slumber. You remembered spiraling down there earlier. Do you remember what you were feeling so anxious about?

>end
You think about how Death finally got you, but it seems you came to Death first.

Death
You re-emerged from the revelation. 

You think you see a gnarled old redwood tree out here.

It didn't have to be this way either. Maybe you can retrace your steps.

>revelation
Revelation
It seems ages since you came to your last conclusion. You had a big idea, but not sure where it ran off to. You can end it here, embracing the eternal slumber. You remembered spiraling down there earlier. Do you remember what you were feeling so anxious about?

>embrace the eternal slumber
You think about how Death finally got you, but it seems you came to Death first.

Death
You re-emerged from the revelation. 

You think you see a gnarled old redwood tree out here.

It didn't have to be this way either. Maybe you can retrace your steps.

* * *

>go revelation
Revelation
It seems ages since you came to your last conclusion. You had a big idea, but not sure where it ran off to. You can end it here, embracing the eternal slumber. You remembered spiraling down there earlier. Do you remember what you were feeling so anxious about?

>examine
What do you want to examine?

>look
Revelation
It seems ages since you came to your last conclusion. You had a big idea, but not sure where it ran off to. You can end it here, embracing the eternal slumber. You remembered spiraling down there earlier. Do you remember what you were feeling so anxious about?

>go spiraling
Spiraling
Round and round we go again. You came out from logical thinking, but it seems never ending here now. Maybe there is a revelation soon if you wait awhile.

>go revelation
Revelation
It seems ages since you came to your last conclusion. You had a big idea, but not sure where it ran off to. You can end it here, embracing the eternal slumber. You remembered spiraling down there earlier. Do you remember what you were feeling so anxious about?

>go spiral
That noun did not make sense in this context.

>spiral
Spiraling
Round and round we go again. You came out from logical thinking, but it seems never ending here now. Maybe there is a revelation soon if you wait awhile.

>end
You can't go that way.

>go revelation
Revelation
It seems ages since you came to your last conclusion. You had a big idea, but not sure where it ran off to. You can end it here, embracing the eternal slumber. You remembered spiraling down there earlier. Do you remember what you were feeling so anxious about?

>end
You think about how Death finally got you, but it seems you came to Death first.

Death

You re-emerged from the revelation. 

You think you see a gnarled old redwood tree out here.

It didn't have to be this way either. Maybe you can retrace your steps.

>go revelation
Revelation
It seems ages since you came to your last conclusion. You had a big idea, but not sure where it ran off to. You can end it here, embracing the eternal slumber. You remembered spiraling down there earlier. Do you remember what you were feeling so anxious about?

>go spiraling
Spiraling
Round and round we go again. You came out from logical thinking, but it seems never ending here now. Maybe there is a revelation soon if you wait awhile.

* * *

>go revelation
Revelation
It seems ages since you came to your last conclusion. You had a big idea, but not sure where it ran off to. You can end it here, embracing the eternal slumber. You remembered spiraling down there earlier. Do you remember what you were feeling so anxious about?

>go death
You think about how Death finally got you, but it seems you came to Death first.

Death
You think you see a gnarled old redwood tree out here.

You re-emerged from the revelation. It didn't have to be this way either. Maybe you can retrace your steps.

>end
You can't go that way.

>go revelation
Revelation
It seems ages since you came to your last conclusion. You had a big idea, but not sure where it ran off to. You can end it here. Or you can go back to the spiral.

>end
You think about how Death finally got you, but it seems you came to Death first.

Death
You think you see a gnarled old redwood tree out here.

You re-emerged from the revelation. It didn't have to be this way either. Maybe you can retrace your steps.

* * *

>go revelation
Revelation
It seems ages since you came to your last conclusion. You had a big idea, but not sure where it ran off to. You can end it here, embracing the eternal slumber. You remembered spiraling down there earlier. Do you remember what you were feeling so anxious about?

>go down
Crossing

>go inside
Thoughts
An idea floats around.

>enter idea
thinking...

You get into the idea.

>get out
You get out of the idea.

Thoughts
An idea floats around.

>enter idea
wow2thinking...

You get into the idea.

>get out
You get out of the idea.

Thoughts
An idea floats around.

* * *

>go spiral
Spiraling
Round and round we go again. Your cyclical thoughts float around the room, taunting you. You did start spiraling from some type of idea, but it seems there you have no logic here. Is this healthy? To stay here, thinking the same thought over and over, unable to break the pattern?

Maybe there is a revelation soon if you wait awhile.

>break the pattern
Thoughts
You hit the flow, entering a thoughtful space. Maybe if you looked into an idea you might be able to find something. You can linger on the decision you had made. 

 You don't know if the choice was optional, something thrust upon you. You might end up spiraling, ruminating on the choices that you made. The choices that plague your mind.

An idea floats around.

>spiral
It isn't safe to do that here.

* * *

>go spiral
Spiraling
Round and round we go again. Your cyclical thoughts float around the room, taunting you. You did start spiraling from some type of idea, but it seems there you have no logic here. Is this healthy? To stay here, thinking the same thought over and over, unable to break the pattern?

Maybe there is a revelation soon if you wait awhile.

>go spiraling
You're already in Spiraling.

>go to revelation
up Revelation

Revelation
What's the big idea? It seems ages since you came to your last conclusion. You can end it here. Or you can go back to the spiral.

* * *

>go spiral
Spiraling
Round and round we go again. Your cyclical thoughts float around the room, taunting you. You did start spiraling from some type of idea, but it seems there you have no logic here. Is this healthy? To stay here, thinking the same thought over and over, unable to break the pattern?

Maybe there is a revelation soon if you wait awhile.

>go think
Thoughts
You hit the flow, entering a thoughtful space. Maybe if you looked into an idea you might be able to find something. You can linger on the decision you had made. 

 You don't know if the choice was optional, something thrust upon you. You might end up spiraling, ruminating on the choices that you made. The choices that plague your mind.

An idea floats around.

* * *

>brainstorm
Thinking...about choices. choices i made. choices that were taken from me.

You get into the idea.

>brainstorm
You get out of the idea.

Thoughts
You hit the flow, entering a thoughtful space. Maybe if you looked into an idea you might be able to find something. You can linger on the decision you had made. 

 You don't know if the choice was optional, something thrust upon you. You might end up spiraling, ruminating on the choices that you made. The choices that plague your mind.

An idea floats around.

Thinking...my heart isn't full its just anxious and worried about the future all the time. is there something beyond this?

You get into the idea.

>exit
You get out of the idea.

Thoughts
You hit the flow, entering a thoughtful space. Maybe if you looked into an idea you might be able to find something. You can linger on the decision you had made. 

 You don't know if the choice was optional, something thrust upon you. You might end up spiraling, ruminating on the choices that you made. The choices that plague your mind.

An idea floats around.

>go spiral
It isn't safe to do that here.

>spiral
It isn't safe to do that here.

* * *

>go think
Thoughts
You hit the flow, entering a thoughtful space. Maybe if you looked into an idea you might be able to find something. You can linger on the decision you had made. 

 You don't know if the choice was optional, something thrust upon you. You might end up spiraling, ruminating on the choices that you made. The choices that plague your mind.

An idea floats around.

>decide
Decision
Was this a great choice? At least you made one. You can think about it further ahead. You descended here from the choice that was presented to you, and now you must live in your decision.

>chose
That noun did not make sense in this context.

>go choose
That noun did not make sense in this context.

>go choice
Choice
This or that. You have options. 

You need to decide to continue. 

Your parents made a choice too, a choice in naming you. When you emerged from birth you were set for something. Was your name a blessing or a curse?

>decide
It isn't safe to do that here.

* * *

>go think
Thoughts
You hit the flow, entering a thoughtful space. Maybe if you looked into an idea you might be able to find something. You can linger on the decision you had made. 

 You don't know if the choice was optional, something thrust upon you. You might end up spiraling, ruminating on the choices that you made. The choices that plague your mind.

An idea floats around.

>go decide
Decision
Was this a great choice? At least you made one. You can think about it further ahead, or you can head back up to the Naming.

>go to Naming
Naming
Emerging from birth you were set for something. Was your name a blessing or a curse?

>go to birth
Birth
The birth of an idea. The beginning of a new story. You can go be named, but you feel a sudden revelation.

>go to name
That noun did not make sense in this context.

* * *

>go think
Thoughts
You hit the flow, entering a thoughtful space. Maybe if you looked into an idea you might be able to find something. You can linger on the decision you had made. 

 You don't know if the choice was optional, something thrust upon you. You might end up spiraling, ruminating on the choices that you made. The choices that plague your mind.

An idea floats around.

>go decision
You can't see any such thing.

>go inside
You can't go that way.

>go up
Decision
Was this a great choice? At least you made one. You can think about it further ahead, or you can head back up.

>go up
Naming
Emerging from birth you were set for something. Was your name a blessing or a curse?

>go birth
You can't see any such thing.

>go in
Birth
The birth of an idea. The beginning of a new story. You can go be named, but you feel a sudden revelation.

>go revelation
You can't go that way.

>go down
Revelation
What's the big idea? It seems ages since you came to your last conclusion. You can end it here. Or you can go back to the spiral.

>go out
End
Emerging from the revelation, the journey finished, you take a deep breath. It didn't have to be this way. Maybe you can retrace your steps.

* * *

>go think
Thoughts
You hit the flow, entering a thoughtful space. Maybe if you looked into an idea you might be able to find something. You can linger on the decision you had made. 

 You don't know if the choice was optional, something thrust upon you. You might end up spiraling, ruminating on the choices that you made. The choices that plague your mind.

An idea floats around.

>go thought
You can't see any such thing.

>go thoughts
Thoughts
Thinking thoughts hard. Maybe if you looked into an idea you might be able to find something. You can linger on the decision you just came from as well.

An idea floats around.

* * *

>go think
Thoughts
You hit the flow, entering a thoughtful space. Maybe if you looked into an idea you might be able to find something. You can linger on the decision you had made. 

 You don't know if the choice was optional, something thrust upon you. You might end up spiraling, ruminating on the choices that you made. The choices that plague your mind.

An idea floats around.

>go up
Decision
Was this a great choice? At least you made one. You can think about it further ahead. You descended here from the choice that was presented to you, and now you must live in your decision.

>go ahead
Thoughts
You hit the flow, entering a thoughtful space. Maybe if you looked into an idea you might be able to find something. You can linger on the decision you had made. 

 You don't know if the choice was optional, something thrust upon you. You might end up spiraling, ruminating on the choices that you made. The choices that plague your mind.

An idea floats around.

>go up
Decision
Was this a great choice? At least you made one. You can think about it further ahead. You descended here from the choice that was presented to you, and now you must live in your decision.

>go further ahead
Thoughts
You hit the flow, entering a thoughtful space. Maybe if you looked into an idea you might be able to find something. You can linger on the decision you had made. 

 You don't know if the choice was optional, something thrust upon you. You might end up spiraling, ruminating on the choices that you made. The choices that plague your mind.

An idea floats around.

>go up
Decision
Was this a great choice? At least you made one. You can think about it further ahead. You descended here from the choice that was presented to you, and now you must live in your decision.

>think about it further ahead
Thoughts
You hit the flow, entering a thoughtful space. Maybe if you looked into an idea you might be able to find something. You can linger on the decision you had made. 

 You don't know if the choice was optional, something thrust upon you. You might end up spiraling, ruminating on the choices that you made. The choices that plague your mind.

An idea floats around.

>go up
Decision
Was this a great choice? At least you made one. You can think about it further ahead. You descended here from the choice that was presented to you, and now you must live in your decision.

>go up
Choice
Emerging from birth you were set for something. Was your name a blessing or a curse?

>go birth
Birth
The birth of an idea. The beginning of a new story. You can go be named, but you feel a sudden revelation.

* * *

>go think
Thoughts
You hit the flow, entering a thoughtful space. Maybe if you looked into an idea you might be able to find something. You can linger on the decision you had made. 

 You don't know if the choice was optional, something thrust upon you. You might end up spiraling, ruminating on the choices that you made. The choices that plague your mind.

An idea floats around.

>look
Thoughts
Thinking thoughts hard. Maybe if you looked into an idea you might be able to find something. You can linger on the decision you just came from as well.

An idea floats around.

>look idea
Maybe you need to be inside the idea to have it.

>go idea
thinking...about choices
You get into the idea.

>look
Thoughts (in the idea)
Thinking thoughts hard. Maybe if you looked into an idea you might be able to find something. You can linger on the decision you just came from as well.

* * *

>go think
Thoughts
You hit the flow, entering a thoughtful space. Maybe if you looked into an idea you might be able to find something. You can linger on the decision you had made. 

 You don't know if the choice was optional, something thrust upon you. You might end up spiraling, ruminating on the choices that you made. The choices that plague your mind.

An idea floats around.

>look idea
Each idea seems to be worth exploring. Brainstorming is always a fruitful adventure that is worth iterating on.

>brainstorm
Thinking...about choices. choices i made. choices that were taken from me.

You get into the idea.

>decide
Decision
Was this a great choice? At least you made one. You can think about it further ahead. You descended here from the choice that was presented to you, and now you are living in your decision. Did you want to think about that choice again?

>choose
That noun did not make sense in this context.

>chose
Choice
This or that. You have options. 

You need to decide to continue. 

Your parents made a choice too, a choice in naming you. When you emerged from birth you were set for something. Was your name a blessing or a curse?

>decide
Decision
Was this a great choice? At least you made one. You can think about it further ahead. You descended here from the choice that was presented to you, and now you are living in your decision. Did you want to think about that choice again?

>chose
Choice
This or that. You have options. 

You need to decide to continue. 

Your parents made a choice too, a choice in naming you. When you emerged from birth you were set for something. Was your name a blessing or a curse?

>birth
Birth
The birth of an idea. The birth of you. The beginning of a new story. You have some choices to be made in the outside world. 

 You feel a sudden revelation. Did you find your Big Idea after all this time?

>go revelation
Revelation
Your last conclusion. You found your big idea, finally. You should embrace the eternal slumber. But you can return to spiraling if you think it necessary. Some journeys are meant to be done more than once.

>embrace the eternal slumber
You are reborn.

    *** The End ***

Would you like to RESTART, RESTORE a saved game, QUIT or UNDO the last command?

* * *

>go think
Thoughts
You hit the flow, entering a thoughtful space. Maybe if you looked into an idea you might be able to find something. You can linger on the decision you had made. 

 You don't know if the choice was optional, something thrust upon you. You might end up spiraling, ruminating on the choices that you made. The choices that plague your mind.

An idea floats around.

>think
Thoughts
You hit the flow, entering a thoughtful space. Maybe if you looked into an idea you might be able to find something. You can linger on the decision you had made. 

 You don't know if the choice was optional, something thrust upon you. You might end up spiraling, ruminating on the choices that you made. The choices that plague your mind.

An idea floats around.

>brainstorm
Thinking...about choices. choices i made. choices that were taken from me.

You get into the idea.

>linger on decision
Decision
Was this a great choice? At least you made one. You can think about it further ahead, or you can head back up to the Naming.

>think
A worthy endeavor. Is thinking embodied ever? How do we map the thought process? How does creativity happen?

 Time passes.

>think about it further ahead
I only understood you as far as wanting to think.

>go further ahead
That noun did not make sense in this context.

>go ahead
That noun did not make sense in this context.

>go down
Thoughts
You hit the flow, entering a thoughtful space. Maybe if you looked into an idea you might be able to find something. You can linger on the decision you had made. 

 You don't know if the choice was optional, something thrust upon you. You might end up spiraling, ruminating on the choices that you made. The choices that plague your mind.

An idea floats around.

>go up
Decision
Was this a great choice? At least you made one. You can think about it further ahead, or you can head back up to the Naming.

* * *

>go spiral
Spiraling
Round and round we go again. Your cyclical thoughts float around the room, taunting you. You did start spiraling from some type of idea, but it seems there you have no logic here. Is this healthy? To stay here, thinking the same thought over and over, unable to break the pattern?

Maybe there is a revelation soon if you wait awhile.

>spiral
It isn't safe to do that here.

>think
What a good idea.

* * *

>spiral
It isn't safe to do that here.

>wait
You ruminated for a moment.

Time passes.

>wait awhile
Standing here is kind of boring, should you meditate?

>wait awhile
Hmmmmm is seems that you have come to a conclusion here. A Revelation perhaps?

Revelation
It seems ages since you came to your last conclusion. You had a big idea, but not sure where it ran off to. You can end it here, embracing the eternal slumber. You remembered spiraling down there earlier. Do you remember what you were feeling so anxious about?

You ruminated for a moment.

>wait
Thoughts drift in and out. It's almost like meditation.

>mediate
That noun did not make sense in this context.

>meditate
Each thought passes you by, is there a way to enter them?

* * *

>go spiral
Spiraling
Round and round we go again. Your cyclical thoughts float around the room, taunting you. You did start spiraling from some type of idea, but it seems there you have no logic here. Is this healthy? To stay here, thinking the same thought over and over, unable to break the pattern?

Maybe there is a revelation soon if you wait awhile.

>think
Thoughts
You hit the flow, entering a thoughtful space. Maybe if you looked into an idea you might be able to find something. You can linger on the decision you had made. 

 You don't know if the choice was optional, something thrust upon you. You might end up spiraling, ruminating on the choices that you made. The choices that plague your mind.

An idea floats around.

* * *

>go revelation
Revelation
It seems ages since you came to your last conclusion. You had a big idea, but not sure where it ran off to. You can end it here, embracing the eternal slumber. You remembered spiraling down there earlier. Do you remember what you were feeling so anxious about?

>go sprial
That noun did not make sense in this context.

>spiral
Spiraling
Round and round we go again. Your cyclical thoughts float around the room, taunting you. You did start spiraling from some type of idea, but it seems there you have no logic here. Is this healthy? To stay here, thinking the same thought over and over, unable to break the pattern?

Maybe there is a revelation soon if you wait awhile.

>think
Thoughts
You hit the flow, entering a thoughtful space. Maybe if you looked into an idea you might be able to find something. You can linger on the decision you had made. 

 You don't know if the choice was optional, something thrust upon you. You might end up spiraling, ruminating on the choices that you made. The choices that plague your mind.

An idea floats around.

* * *

>go revelation
Revelation
It seems ages since you came to your last conclusion. You had a big idea, but not sure where it ran off to. You can end it here, embracing the eternal slumber. You remembered spiraling down there earlier. Do you remember what you were feeling so anxious about?

>inside
Revelation
What's the big idea? It seems ages since you came to your last conclusion. You can end it here. Or you can go back to the spiral.

>go end
End
You re-emerged from the revelation. It didn't have to be this way either maybe.

>go revelation
Which do you mean, the down or the inside?

>inside
Revelation
What's the big idea? It seems ages since you came to your last conclusion. You can end it here. Or you can go back to the spiral.

* * *

>go think
Thoughts
Thinking thoughts hard. Maybe if you looked into an idea you might be able to find something. You can linger on the decision you just came from as well.

An idea floats around.

>go decide
Decision
Was this a great choice? At least you made one. You can think about it further ahead, or you can head back up to the Naming.

>go up
Naming
Emerging from birth you were set for something. Was your name a blessing or a curse?

* * *

>go revelation
Which do you mean, the down or the inside?

>go down
Revelation
What's the big idea? It seems ages since you came to your last conclusion. You can end it here. Or you can go back to the spiral.

>go end
End
You are reborn.

* * *

>go think
Thoughts
Thinking thoughts hard. Maybe if you looked into an idea you might be able to find something. You can linger on the decision you just came from as well.

An idea floats around.

>go decide
You can't see any such thing.

>go Decision
Decision
Was this a great choice? At least you made one. You can think about it further ahead, or you can head back up to the Naming.

>go up
Naming
Emerging from birth you were set for something. Was your name a blessing or a curse?

* * *

>down
Revelation
What's the big idea? It seems ages since you came to your last conclusion. You can end it here. Or you can go back to the spiral.

>go end
You can't see any such thing.

>go outside
End
Emerging from the revelation, the journey finished, you take a deep breath. It didn't have to be this way. Maybe you can retrace your steps.

>look
End
Emerging from the revelation, the journey finished, you take a deep breath. It didn't have to be this way. Maybe you can retrace your steps.

>lookend
That's not a verb I recognise.

>look end
You can't see any such thing.

>end
That's not a verb I recognise.

>end the story
That's not a verb I recognise.

>go revelation
Which do you mean, the down or the inside?

>down
You can't go that way.

>go revelation
Which do you mean, the down or the inside?

* * *

>inside
Revelation
What's the big idea? It seems ages since you came to your last conclusion. You can end it here. Or you can go back to the spiral.

>go end
You can't see any such thing.

* * *

I beg your pardon?

>look
Death
Emerging from the revelation, the journey finished, you take a deep breath. It didn't have to be this way. Maybe you can retrace your steps.

>enter revelation
You can't see any such thing.

* * *

>go revelation
Revelation
It seems ages since you came to your last conclusion. You had a big idea, but not sure where it ran off to. You can end it here, embracing the eternal slumber. You remembered spiraling down there earlier. Do you remember what you were feeling so anxious about?

>spiral
Spiraling
Round and round we go again. Your cyclical thoughts float around the room, taunting you. You did start spiraling from some type of idea, but it seems there you have no logic here. Is this healthy? To stay here, thinking the same thought over and over, unable to break the pattern?

Maybe there is a revelation soon if you wait awhile.

>break the pattern
Thoughts
You hit the flow, entering a thoughtful space. Maybe if you looked into an idea you might be able to find something. You can linger on the decision you just came from as well.

An idea floats around.

>spiral
It isn't safe to do that here.

>go spiraling
Spiraling
Round and round we go again. Your cyclical thought patterns are doing no good here. You did stem from some type of thinking, but it seems there you have no logic here. Is this healthy? To stay here, thinking the same thought over and over, unable to break the pattern?

Maybe there is a revelation soon if you wait awhile.

>go back
That noun did not make sense in this context.

* * *

>spiral
Spiraling
Round and round we go again. Your cyclical thoughts float around the room, taunting you. You did start spiraling from some type of idea, but it seems there you have no logic here. Is this healthy? To stay here, thinking the same thought over and over, unable to break the pattern?

Maybe there is a revelation soon if you wait awhile.

>go revelation
Revelation

It seems ages since you came to your last conclusion. You had a big idea, but not sure where it ran off to. You can end it here, embracing the eternal slumber. You remembered spiraling down there earlier. Do you remember what you were feeling so anxious about?

>spiraling
Spiraling
Round and round we go again. You came out from logical thinking, but it seems there is no logic here. Maybe there is a revelation soon if you wait awhile.

* * *

>spiral
Spiraling
Round and round we go again. Your cyclical thoughts float around the room, taunting you. You did start spiraling from some type of idea, but it seems there you have no logic here. Is this healthy? To stay here, thinking the same thought over and over, unable to break the pattern?

Maybe there is a revelation soon if you wait awhile.

>think
What a good idea.

>t
That noun did not make sense in this context.

* * *

>spiral
Spiraling
Round and round we go again. Your cyclical thoughts float around the room, taunting you. You did start spiraling from some type of idea, but it seems there you have no logic here. Is this healthy? To stay here, thinking the same thought over and over, unable to break the pattern?

Maybe there is a revelation soon if you wait awhile.

>wait
You ruminated for a moment.

Time passes.

>wait
Standing here is kind of boring, should you meditate?

Time passes.

>wait
Time passes.

It seems that you have come to a conclusion here again. You found your Big Idea!

Revelation
It seems ages since you came to your last conclusion. You had a big idea, but not sure where it ran off to. You can end it here, embracing the eternal slumber. You remembered spiraling down there earlier. Do you remember what you were feeling so anxious about?

* * *

A Linear Story
An Interactive Fiction by Sam Heckle
Release 1 / Serial number 220502 / Inform 7 build 6M62 (I6/v6.34 lib 6/12N) SD

Death
Emerging from the Revelation, the journey finished, you take a deep breath. A seemingly endless labyrinth of thinking. A pattern only broken by Death itself. 

You think you see a gnarled old redwood tree out here.

 It didn't have to be this way. Maybe you can retrace your steps.

>go spiral
That noun did not make sense in this context.

>go spiraling
That doesn't make sense.

>go revelation
Revelation

It seems ages since you came to your last conclusion. You had a big idea, but not sure where it ran off to. You can end it here, embracing the eternal slumber. You remembered spiraling down there earlier. Do you remember what you were feeling so anxious about?

>spiral
Spiraling
Round and round we go again. You came out from logical thinking, but it seems there is no logic here. Maybe there is a revelation soon if you wait awhile.

>wait awhile
Thoughts
Thinking thoughts hard. Maybe if you looked into an idea you might be able to find something. You can linger on the decision you just came from as well.

An idea floats around.

* * *

A Linear Story
An Interactive Fiction by Sam Heckle
Release 1 / Serial number 220502 / Inform 7 build 6M62 (I6/v6.34 lib 6/12N) SD

Death
Emerging from the Revelation, the journey finished, you take a deep breath. A seemingly endless labyrinth of thinking. A pattern only broken by Death itself. 

You think you see a gnarled old redwood tree out here.

 It didn't have to be this way. Maybe you can retrace your steps.

>go to revelation
Revelation
What's the big idea? It seems ages since you came to your last conclusion. You can end it here. Or you can go back to the spiral.

I beg your pardon?

>to revelation
That noun did not make sense in this context.

>go revelation
Which do you mean, the down or the inside?

>revelation
Which do you mean, the down or the inside?

>inside
Revelation
What's the big idea? It seems ages since you came to your last conclusion. You can end it here. Or you can go back to the spiral.

>revelation
Which do you mean, the down or the inside?

* * *

>go to revelation
Revelation
What's the big idea? It seems ages since you came to your last conclusion. You can end it here. Or you can go back to the spiral.

>go to birth
That noun did not make sense in this context.

* * *

>go to revelation
Revelation
What's the big idea? It seems ages since you came to your last conclusion. You can end it here. Or you can go back to the spiral.

>go to death
 You think about how Death finally came to you, but it seems you came to Death.

Death
You re-emerged from the revelation. It didn't have to be this way either. Maybe you can retrace your steps.

* * *

A Linear Story
An Interactive Fiction by Sam Heckle
Release 1 / Serial number 220502 / Inform 7 build 6M62 (I6/v6.34 lib 6/12N) SD

Death
Emerging from the Revelation, the journey finished, you take a deep breath. A seemingly endless labyrinth of thinking. A pattern only broken by Death itself. 

You think you see a gnarled old redwood tree out here.

 It didn't have to be this way. Maybe you can retrace your steps.

>look
Death
Emerging from the Revelation, the journey finished, you take a deep breath. A seemingly endless labyrinth of thinking. A pattern only broken by Death itself. 

It didn't have to be this way. Maybe you can retrace your steps.

>examine
(the gnarled old redwood tree)
You see nothing special about the gnarled old redwood tree.

Penny is the same woman who stepped on your toe in the buffet line. The third time, she blurted, "You have big shoes, don't you?"

>look gnarled old redwood tree
You see nothing special about the gnarled old redwood tree.

* * *

>examine
(the gnarled old redwood tree)
You see nothing special about the gnarled old redwood tree.

Penny is the same woman who stepped on your toe in the buffet line. The third time, she blurted, "You have big shoes, don't you?"

>search
(the gnarled old redwood tree)
You find nothing of interest.

* * *

>look
Death
Emerging from the Revelation, the journey finished, you take a deep breath. A seemingly endless labyrinth of thinking. A pattern only broken by Death itself. 

It didn't have to be this way. Maybe you can retrace your steps.

>go to revelation
Revelation
What's the big idea? It seems ages since you came to your last conclusion. You can end it here. Or you can go back to the spiral.

>go to death
you think
Death
You re-emerged from the revelation. It didn't have to be this way either. Maybe you can retrace your steps.

* * *

>look
Death
Emerging from the Revelation, the journey finished, you take a deep breath. A seemingly endless labyrinth of thinking. A pattern only broken by Death itself. 

It didn't have to be this way. Maybe you can retrace your steps.

>journey
That's not a verb I recognise.

>i
You are carrying nothing.

>go revelation
Revelation

>look
Revelation

>go down
Crossing

* * *

>go inside
Thoughts
An idea floats around.

>look idea
The idea is empty.

>go inside idea
thinking...

You get into the idea.

>look
Thoughts (in the idea)

>go up
You would have to get out of the idea first.

>look
Thoughts (in the idea)

>get out of idea
I only understood you as far as wanting to get outside.

>get out
You get out of the idea.

Thoughts
An idea floats around.

>take idea
That's fixed in place.

>look idea
The idea is empty.

>take idea
That's fixed in place.

* * *

A Linear Story
An Interactive Fiction by Sam Heckle
Release 1 / Serial number 220502 / Inform 7 build 6M62 (I6/v6.34 lib 6/12N) SD

Death
Emerging from the Revelation, the journey finished, you take a deep breath. A seemingly endless labyrinth of thinking. A pattern only broken by Death itself. 

You think you see a gnarled old redwood tree out here.

 It didn't have to be this way. Maybe you can retrace your steps.

>retrace steps
Revelation
It seems ages since you came to your last conclusion. You had a big idea, but not sure where it ran off to. You can end it here, embracing the eternal slumber. You remembered spiraling down there earlier. Do you remember what you were feeling so anxious about?

>go back
That noun did not make sense in this context.

* * *

>lok
That noun did not make sense in this context.

>look
Death
You re-emerged from the revelation. It didn't have to be this way either maybe.

>examine
(the gnarled old redwood tree)
You see nothing special about the gnarled old redwood tree.

>look
Death
You re-emerged from the revelation. It didn't have to be this way either maybe.

* * *

>retrace steps
Revelation
It seems ages since you came to your last conclusion. You had a big idea, but not sure where it ran off to. You can end it here, embracing the eternal slumber. You remembered spiraling down there earlier. Do you remember what you were feeling so anxious about?

>go death
 You think about how Death finally got you, but it seems you came to Death first.

Death
You re-emerged from the revelation. It didn't have to be this way either. Maybe you can retrace your steps.

>look
Death
You re-emerged from the revelation. It didn't have to be this way either. Maybe you can retrace your steps.

* * *

>retrace steps
Revelation
It seems ages since you came to your last conclusion. You had a big idea, but not sure where it ran off to. You can end it here, embracing the eternal slumber. You remembered spiraling down there earlier. Do you remember what you were feeling so anxious about?

>go revelation
Revelation
What's the big idea? It seems ages since you came to your last conclusion. You can end it here. Or you can go back to the spiral.

>retrace steps
There are no footsteps to follow.

* * *

>retrace steps
Revelation
It seems ages since you came to your last conclusion. You had a big idea, but not sure where it ran off to. You can end it here, embracing the eternal slumber. You remembered spiraling down there earlier. Do you remember what you were feeling so anxious about?

>spiral
Spiraling
Round and round we go again. Your cyclical thoughts float around the room, taunting you. You did start spiraling from some type of idea, but it seems there you have no logic here. Is this healthy? To stay here, thinking the same thought over and over, unable to break the pattern?

Maybe there is a revelation soon if you wait awhile.

* * *

>think
Thoughts
You hit the flow, entering a thoughtful space. Maybe if you looked into an idea you might be able to find something. You can linger on the decision you had made. 

 You don't know if the choice was optional, something thrust upon you. You might end up spiraling, ruminating on the choices that you made. The choices that plague your mind.

An idea floats around.

>look idea
Each idea seems to be worth exploring. Brainstorming is always a fruitful adventure that is worth iterating on.

* * *

>brainstorm
Thinking...about choices. choices i made. choices that were taken from me.

You get into the idea.

>brainstorm
But you're already in the idea.

* * *

>wait
Standing here is kind of boring, should you meditate?

Time passes.

>wait
Hmmmmm is seems that you have come to a conclusion here. A Revelation perhaps?

Revelation
It seems ages since you came to your last conclusion. You had a big idea, but not sure where it ran off to. You can end it here, embracing the eternal slumber. You remembered spiraling down there earlier. Do you remember what you were feeling so anxious about?

You ruminated for a moment.

Time passes.

>spiral
Spiraling
Round and round we go again. Your cyclical thought patterns are doing no good here. You did stem from some type of thinking, but it seems there you have no logic here. Is this healthy? To stay here, thinking the same thought over and over, unable to break the pattern?

Maybe there is a revelation soon if you wait awhile.

>break the pattern
Thoughts
You hit the flow, entering a thoughtful space. Maybe if you looked into an idea you might be able to find something. You can linger on the decision you just came from as well.

An idea floats around.

* * *

>wait
You ruminated for a moment.

Time passes.

>wait awhile
You ruminated for a moment.

>wait
Time passes.

>wait awhi.e
I only understood you as far as wanting to wait.

>wait awhile
Standing here is kind of boring, should you meditate?

>meditate
Each thought passes you by, is there a way to enter them?

>wait awhile
Hmmmmm is seems that you have come to a conclusion here. A Revelation perhaps?

Thoughts
Thinking thoughts hard. Maybe if you looked into an idea you might be able to find something. You can linger on the decision you just came from as well.

An idea floats around.

You ruminated for a moment.

* * *

A Linear Story
An Interactive Fiction by Sam Heckle
Release 1 / Serial number 220502 / Inform 7 build 6M62 (I6/v6.34 lib 6/12N) SD

Death
Emerging from the Revelation, the journey finished, you take a deep breath. A seemingly endless labyrinth of thinking. A pattern only broken by Death itself. 

You think you see a gnarled old redwood tree out here.

 It didn't have to be this way. Maybe you can retrace your steps.

>showme
End - room
    yourself - person
    gnarled old redwood tree

* * *

A Linear Story
An Interactive Fiction by Sam Heckle
Release 1 / Serial number 220502 / Inform 7 build 6M62 (I6/v6.34 lib 6/12N) SD

Death
Emerging from the Revelation, the journey finished, you take a deep breath. A seemingly endless labyrinth of thinking. A pattern only broken by Death itself. 

You think you see a gnarled old redwood tree out here.

 It didn't have to be this way. Maybe you can retrace your steps.

>spiral
It isn't safe to do that here.

>go revelation
Revelation
It seems ages since you came to your last conclusion. You had a big idea, but not sure where it ran off to. You can end it here, embracing the eternal slumber. You remembered spiraling down there earlier. Do you remember what you were feeling so anxious about?

* * *

>go think
Thoughts
You hit the flow, entering a thoughtful space. Maybe if you looked into an idea you might be able to find something. You can linger on the decision you had made. 

 You don't know if the choice was optional, something thrust upon you. You might end up spiraling, ruminating on the choices that you made. The choices that plague your mind.

An idea floats around.

>go spiral
It isn't safe to do that here.

Spiraling
Round and round we go again. Your cyclical thoughts float around the room, taunting you. You did start spiraling from some type of idea, but it seems there you have no logic here. Is this healthy? To stay here, thinking the same thought over and over, unable to break the pattern?

Maybe there is a revelation soon if you wait awhile.

>search
What do you want to search?

>go think
Thoughts
You hit the flow, entering a thoughtful space. Maybe if you looked into an idea you might be able to find something. You can linger on the decision you had made. 

 You don't know if the choice was optional, something thrust upon you. You might end up spiraling, ruminating on the choices that you made. The choices that plague your mind.

An idea floats around.

>search idea
The idea is empty.

* * *

>think
Thoughts
You hit the flow, entering a thoughtful space. Maybe if you looked into an idea you might be able to find something. You can linger on the decision you had made. 

 You don't know if the choice was optional, something thrust upon you. You might end up spiraling, ruminating on the choices that you made. The choices that plague your mind.

An idea floats around.

>go spiral
Spiraling
Round and round we go again. Your cyclical thoughts float around the room, taunting you. You did start spiraling from some type of idea, but it seems there you have no logic here. Is this healthy? To stay here, thinking the same thought over and over, unable to break the pattern?

Maybe there is a revelation soon if you wait awhile.

* * *

A Linear Story
An Interactive Fiction by Sam Heckle
Release 1 / Serial number 220502 / Inform 7 build 6M62 (I6/v6.34 lib 6/12N) SD

Death
Emerging from the Revelation, the journey finished, you take a deep breath. A seemingly endless labyrinth of thinking. A pattern only broken by Death itself. 

You think you see a gnarled old redwood tree out here.

 It didn't have to be this way. Maybe you can retrace your steps.

>think
A worthy endeavor. Is thinking embodied ever? How do we map the thought process? How does creativity happen? 

 Time passes.

>go revelation
Revelation
It seems ages since you came to your last conclusion. You had a big idea, but not sure where it ran off to. You can end it here, embracing the eternal slumber. You remembered spiraling down there earlier. Do you remember what you were feeling so anxious about?

>spiral
Spiraling
Round and round we go again. You came out from logical thinking, but it seems there is no logic here. Maybe there is a revelation soon if you wait awhile.

* * *

>go revelation
Revelation
It seems ages since you came to your last conclusion. You had a big idea, but not sure where it ran off to. You can end it here, embracing the eternal slumber. You remembered spiraling down there earlier. Do you remember what you were feeling so anxious about?

>spiraling down
Spiraling
Round and round we go again. Your cyclical thought patterns are doing no good here. You did stem from some type of thinking, but it seems there you have no logic here. Is this healthy? To stay here, thinking the same thought over and over, unable to break the pattern?

Maybe there is a revelation soon if you wait awhile.

>think
Thoughts
You hit the flow, entering a thoughtful space. Maybe if you looked into an idea you might be able to find something. You can linger on the decision you had made. 

 You don't know if the choice was optional, something thrust upon you. You might end up spiraling, ruminating on the choices that you made. The choices that plague your mind.

An idea floats around.

>look
Thoughts
You hit the flow, entering a thoughtful space. Maybe if you looked into an idea you might be able to find something. You can linger on the decision you had made. 

 You don't know if the choice was optional, something thrust upon you. You might end up spiraling, ruminating on the choices that you made. The choices that plague your mind.

An idea floats around.

>look idea
Each idea seems to be worth exploring. Brainstorming is always a fruitful adventure that is worth iterating on.

>x idea
Each idea seems to be worth exploring. Brainstorming is always a fruitful adventure that is worth iterating on.

>brainstorm
Thinking...about choices. choices i made. choices that were taken from me.

You get into the idea.

* * *

A Linear Story
An Interactive Fiction by Sam Heckle
Release 1 / Serial number 220502 / Inform 7 build 6M62 (I6/v6.34 lib 6/12N) SD

Death
Emerging from the Revelation, the journey finished, you take a deep breath. A seemingly endless labyrinth of thinking. A pattern only broken by Death itself. 

You think you see a gnarled old redwood tree out here.

 It didn't have to be this way. Maybe you can retrace your steps.

>wait
Thoughts drift in and out. It's almost like meditation.

>go revelation
Revelation
It seems ages since you came to your last conclusion. You had a big idea, but not sure where it ran off to. You can end it here, embracing the eternal slumber. You remembered spiraling down there earlier. Do you remember what you were feeling so anxious about?

>spiral
Spiraling
Round and round we go again. Your cyclical thought patterns are doing no good here. You did stem from some type of thinking, but it seems there you have no logic here. Is this healthy? To stay here, thinking the same thought over and over, unable to break the pattern?

Maybe there is a revelation soon if you wait awhile.

>wait
You ruminated for a moment.

Time passes.

* * *

>wait
Standing here is kind of boring, should you meditate?

Time passes.

>wait
Time passes.

It seems that you have come to a conclusion here again. You found your Big Idea!

Revelation
It seems ages since you came to your last conclusion. You had a big idea, but not sure where it ran off to. You can end it here, embracing the eternal slumber. You remembered spiraling down there earlier. Do you remember what you were feeling so anxious about?

You ruminated for a moment.

Time passes.

* * *

>wait
You ruminated for a moment.

Time passes.

>wait awhile
Standing here is kind of boring, should you meditate?

Time passes.

>wait
Hmmmmm is seems that you have come to a conclusion here. A Revelation perhaps?

Time passes.

* * *

>wait
Thoughts drift in and out. It's almost like meditation.

>wait
Thoughts drift in and out. It's almost like meditation.

* * *

>wait
Standing here is kind of boring, should you meditate?

Time passes.

>wait
Hmmmmm is seems that you have come to a conclusion here. A Revelation perhaps?

Time passes.

* * *

A Linear Story
An Interactive Fiction by Sam Heckle
Release 1 / Serial number 220502 / Inform 7 build 6M62 (I6/v6.34 lib 6/12N) SD

Death
Emerging from the Revelation, the journey finished, you take a deep breath. A seemingly endless labyrinth of thinking. A pattern only broken by Death itself. 

You think you see a gnarled old redwood tree out here.

 It didn't have to be this way. Maybe you can retrace your steps.

>x gnarled old redwood tree
You see nothing special about the gnarled old redwood tree.

It reminds you to be rooted, to not let your thoughts get away from you.